{
  "stage":"71",
  "size":"8x8",
  "puzzles":[5,8,13,14,17,20,23,25,28,29],
  "board":[
    "O","O","O","O","X","O","O","O",
    "O","O","O","O","X","X","O","O",
    "O","O","O","X","X","O","O","O",
    "O","O","O","O","X","O","O","O",
    "O","O","O","O","O","O","O","O",
    "X","O","O","O","O","O","O","O",
    "X","O","X","O","O","O","O","O",
    "X","X","X","O","O","O","O","O"
  ]
}