{
  "stage":"70",
  "size":"8x8",
  "puzzles":[7,8,10,11,13,14,16,20,24],
  "board":[
    "X","X","O","O","X","X","X","X",
    "O","O","O","O","X","X","O","X",
    "O","O","O","O","O","X","O","O",
    "O","O","O","O","O","X","O","O",
    "O","O","O","O","X","X","O","O",
    "O","O","O","O","O","O","O","O",
    "X","O","O","O","O","O","O","O",
    "X","X","O","O","O","O","X","X"
  ]
}