{
  "stage":"51",
  "size":"8x8",
  "puzzles":[2,4,7,9,14,14,17,21,25],
  "board":[
    "O","O","X","O","O","O","O","O",
    "O","O","X","O","O","O","O","O",
    "O","O","O","O","O","O","O","O",
    "O","O","O","O","O","X","O","O",
    "O","O","O","O","O","X","O","O",
    "O","O","O","O","O","X","O","O",
    "O","O","O","O","O","X","O","O",
    "O","O","O","X","X","X","O","O"
  ]
}