{
  "stage":"14",
  "size":"8x8",
  "puzzles":[1,1,3,5,5,6,7,7,9],
  "board":[
    "X","X","X","X","X","X","X","X",
    "X","O","O","X","X","O","O","X",
    "O","O","O","O","O","O","O","O",
    "O","O","O","O","O","O","O","O",
    "O","X","X","O","O","O","O","O",
    "X","X","X","O","O","O","O","X",
    "X","X","O","O","O","O","X","X",
    "X","X","X","O","O","X","X","X"
  ]
}