{
  "stage":"39",
  "size":"7x7",
  "puzzles":[8,14,17,18,18,20,23],
  "board":[
    "X","X","X","X","X","X","X",
    "O","O","O","O","O","O","O",
    "O","O","O","O","O","O","O",
    "O","O","O","O","X","O","O",
    "O","O","O","O","X","X","O",
    "O","O","O","X","X","O","O",
    "O","O","O","O","X","O","O",
  ]
}