{
  "stage":"48",
  "size":"8x8",
  "puzzles":[4,12,16,20,22,23,26],
  "board":[
    "X","O","O","O","O","O","O","O",
    "X","O","O","O","O","O","O","O",
    "O","O","O","O","O","O","O","O",
    "O","O","O","O","O","O","O","O",
    "O","O","O","O","O","O","O","O",
    "O","O","O","O","O","O","O","O",
    "O","O","O","O","O","O","O","X",
    "X","X","O","O","O","O","O","X"
  ]
}