{
  "stage":"77",
  "size":"8x8",
  "puzzles":[1,11,14,21,22,23,23,27,29],
  "board":[
    "O","O","X","X","O","O","X","X",
    "O","O","O","X","O","O","O","X",
    "O","O","O","O","O","O","O","O",
    "X","X","O","O","O","O","O","O",
    "X","X","O","O","O","O","O","O",
    "O","O","O","O","O","O","O","O",
    "O","O","O","O","O","O","O","O",
    "X","X","O","O","O","O","O","O"
  ]
}