{
  "stage":"72",
  "size":"8x8",
  "puzzles":[2,5,8,7,14,16,17,26,27],
  "board":[
    "O","O","X","O","O","O","O","O",
    "O","O","X","O","O","O","O","O",
    "O","O","X","O","O","X","O","O",
    "O","O","X","O","O","X","O","O",
    "O","O","O","O","O","X","O","O",
    "O","O","O","O","O","X","O","O",
    "O","O","O","O","O","X","O","O",
    "O","O","O","O","O","X","O","O"
  ]
}