{
  "stage":"78",
  "size":"8x8",
  "puzzles":[13,17,20,21,23,23,24,25,30,30],
  "board":[
    "O","O","O","O","O","O","O","X",
    "O","O","O","O","O","O","O","O",
    "O","O","O","O","O","O","O","O",
    "X","O","O","O","O","O","O","O",
    "X","O","O","O","O","O","O","O",
    "X","O","O","O","O","X","X","X",
    "X","O","O","O","O","O","O","X",
    "X","O","O","O","O","O","X","X"
  ]
}