{
  "stage":"80",
  "size":"8x8",
  "puzzles":[6,9,10,12,15,16,18,21,23,29],
  "board":[
    "O","O","O","O","O","O","O","O",
    "O","O","O","X","O","X","O","O",
    "O","O","O","O","O","O","O","O",
    "O","O","O","O","O","O","O","O",
    "O","O","O","X","O","O","O","X",
    "O","O","O","O","O","O","O","O",
    "O","X","O","O","O","O","O","X",
    "O","O","O","O","O","O","O","X"
  ]
}