{
  "stage":"75",
  "size":"8x8",
  "puzzles":[29,28,23,14,18,11,6,28,25,24],
  "board":[
    "X","O","O","O","O","O","X","X",
    "X","O","O","O","O","O","O","X",
    "X","O","O","O","O","O","O","O",
    "X","O","O","O","X","O","O","O",
    "O","O","O","X","O","O","O","X",
    "O","O","O","O","O","O","O","X",
    "X","O","O","O","O","O","O","X",
    "X","X","O","O","O","O","O","X"
  ]
}