{
  "stage":"26",
  "size":"7x7",
  "puzzles":[5,6,9,18,18,17],
  "board":[
    "X","X","O","O","X","X","X",
    "X","O","O","O","O","X","X",
    "O","O","O","O","O","O","X",
    "O","O","O","O","O","O","O",
    "X","O","O","O","O","O","O",
    "X","X","O","O","O","O","X",
    "X","X","X","O","O","X","X"
  ]
}