{
  "stage":"67",
  "size":"7x7",
  "puzzles":[5,9,11,14,20,21,27],
  "board":[
    "O","O","O","O","O","O","O",
    "O","O","O","X","O","O","O",
    "O","O","X","O","O","O","O",
    "O","X","O","O","O","O","O",
    "O","O","O","O","O","O","O",
    "O","O","O","O","O","O","O",
    "O","O","O","O","O","O","O"
  ]
}