{
  "stage":"73",
  "size":"8x8",
  "puzzles":[5,13,14,15,18,20,23,23,24,25,28,30],
  "board":[
    "X","O","O","O","O","X","O","X",
    "O","O","O","O","O","O","O","O",
    "X","O","O","O","O","O","O","O",
    "O","O","O","O","O","O","O","O",
    "O","O","O","O","O","O","O","O",
    "O","O","O","O","O","O","O","X",
    "O","O","O","O","O","O","O","O",
    "X","O","X","O","O","O","O","X"
  ]
}