{
  "stage":"79",
  "size":"8x8",
  "puzzles":[1,8,14,14,16,19,20,21,24],
  "board":[
    "O","O","O","O","X","X","O","O",
    "O","O","O","O","O","X","O","O",
    "X","X","X","X","O","X","O","O",
    "O","O","O","O","O","O","O","O",
    "O","O","O","O","O","O","O","O",
    "O","O","X","O","O","X","O","O",
    "X","O","X","O","O","O","O","O",
    "X","O","X","X","O","O","O","O"
  ]
}