{
  "stage":"50",
  "size":"8x8",
  "puzzles":[2,10,14,18,20,22,23,25,26],
  "board":[
    "O","O","O","O","O","O","O","O",
    "O","O","O","O","O","O","O","O",
    "O","O","O","O","O","O","O","O",
    "O","O","X","O","O","O","O","O",
    "O","O","X","O","O","O","O","O",
    "O","O","X","O","O","X","X","X",
    "O","O","X","O","O","O","O","X",
    "O","O","X","O","O","O","O","X"
  ]
}